 ┏━━━━━━━━━━━━━━━━━━━━━━━━━┓ ┏━━━━━━━━━━━━━━━━━━━━━━━━━┓ 
 ┃                         ┃ ┃                         ┃ 
 ┃   ┏━━━━━┓   ┏━━━━━━━┓   ┃ ┃   ┏━━━━━━━┓   ┏━━━━━┓   ┃ 
 ┃   ┃     ┃   ┃       ┃   ┃ ┃   ┃       ┃   ┃     ┃   ┃ 
 ┃   ┗━━━━━┛   ┗━━━━━━━┛   ┗━┛   ┗━━━━━━━┛   ┗━━━━━┛   ┃ 
 ┃                                                     ┃ 
 ┃   ┏━━━━━┓   ┏━┓   ┏━━━━━━━━━━━━━┓   ┏━┓   ┏━━━━━┓   ┃ 
 ┃   ┗━━━━━┛   ┃ ┃   ┗━━━━━┓ ┏━━━━━┛   ┃ ┃   ┗━━━━━┛   ┃ 
 ┃             ┃ ┃         ┃ ┃         ┃ ┃             ┃ 
 ┗━━━━━━━━━┓   ┃ ┗━━━━━┓   ┃ ┃   ┏━━━━━┛ ┃   ┏━━━━━━━━━┛ 
           ┃   ┃ ┏━━━━━┛   ┗━┛   ┗━━━━━┓ ┃   ┃           
           ┃   ┃ ┃                     ┃ ┃   ┃           
           ┃   ┃ ┃   ┏━━━┳━━━━━┳━━━┓   ┃ ┃   ┃           
 ━━━━━━━━━━┛   ┗━┛   ┃ ┏━┛     ┗━┓ ┃   ┗━┛   ┗━━━━━━━━━━ 
                     ┃ ┃         ┃ ┃                     
 ━━━━━━━━━━┓   ┏━┓   ┃ ┗━━━━━━━━━┛ ┃   ┏━┓   ┏━━━━━━━━━━ 
           ┃   ┃ ┃   ┗━━━━━━━━━━━━━┛   ┃ ┃   ┃           
           ┃   ┃ ┃                     ┃ ┃   ┃           
           ┃   ┃ ┃   ┏━━━━━━━━━━━━━┓   ┃ ┃   ┃           
 ┏━━━━━━━━━┛   ┗━┛   ┗━━━━━┓ ┏━━━━━┛   ┗━┛   ┗━━━━━━━━━┓ 
 ┃                         ┃ ┃                         ┃ 
 ┃   ┏━━━━━┓   ┏━━━━━━━┓   ┃ ┃   ┏━━━━━━━┓   ┏━━━━━┓   ┃ 
 ┃   ┗━━━┓ ┃   ┗━━━━━━━┛   ┗━┛   ┗━━━━━━━┛   ┃ ┏━━━┛   ┃ 
 ┃       ┃ ┃                                 ┃ ┃       ┃ 
 ┗━━━┓   ┃ ┃   ┏━┓   ┏━━━━━━━━━━━━━┓   ┏━┓   ┃ ┃   ┏━━━┛ 
 ┏━━━┛   ┗━┛   ┃ ┃   ┗━━━━━┓ ┏━━━━━┛   ┃ ┃   ┗━┛   ┗━━━┓ 
 ┃             ┃ ┃         ┃ ┃         ┃ ┃             ┃ 
 ┃   ┏━━━━━━━━━┛ ┗━━━━━┓   ┃ ┃   ┏━━━━━┛ ┗━━━━━━━━━┓   ┃ 
 ┃   ┗━━━━━━━━━━━━━━━━━┛   ┗━┛   ┗━━━━━━━━━━━━━━━━━┛   ┃ 
 ┃                                                     ┃ 
 ┗━━━━━━━━━━━━━━━━━━━━━━━━━━━━━━━━━━━━━━━━━━━━━━━━━━━━━┛ 